
5 4 2 0 0 0 0 0 0 0 0 0 
0 0 4 4 4 4 4 4 4 2 0 0 
0 0 0 0 0 0 0 0 0 2 0 0 
0 0 0 0 0 0 0 0 0 4 4 2
0 0 0 0 0 0 0 0 0 0 0 6